╔═══════                       
║      ■                       
╠ ╦═╦═╦═╦═╦═╦═╦═╦═╦═╦═╦═╦═╦═╦═╗
║ ║   ║   ║       ║   ║   ║   ║
╠ ╬ ╬ ╬ ╬ ╬ ╬ ╬ ╬ ╬ ╬ ╬ ╬ ╬ ╬ ╣
║ ║ ║ ║ ║ ║ ║   ║ ║ ║ ║ ║   ║ ║
╠ ╬ ╬ ╬ ╬ ╬ ╬ ╬ ╬ ╬ ╬ ╬ ╬ ╬ ╬ ╣
║   ║ ║ ║ ║ ║   ║ ║ ║ ║   ║   ║
╠ ╬ ╬ ╬ ╬ ╬ ╬ ╬ ╬ ╬ ╬ ╬ ╬ ╬ ╬ ╣
║     ║ ║   ║   ║ ║ ║ ║   ║   ║
╠ ╬ ╬ ╬ ╬*╬ ╬ ╬ ╬ ╬ ╬ ╬ ╬ ╬ ╬ ╣
║ ║     ║       ║ ║ ║ ║   ║   ║
╠ ╬ ╬ ╬ ╬ ╬ ╬ ╬ ╬ ╬ ╬ ╬ ╬ ╬ ╬ ╣
║   ║     ║   ║ ║   ║     ║ * ║
╠ ╬ ╬ ╬ ╬ ╬ ╬ ╬ ╬ ╬ ╬ ╬ ╬ ╬ ╬ ╣
║     ║   ║ ║ ║             ║ ║
╠ ╬ ╬ ╬ ╬ ╬ ╬ ╬ ╬ ╬ ╬ ╬ ╬ ╬ ╬ ╣
║       ║ ║ ║ ║     ║     ║ ║ ║
╠ ╬ ╬ ╬ ╬ ╬ ╬ ╬ ╬ ╬ ╬ ╬ ╬ ╬ ╬ ╣
║         ║ ║ ║   ║ ║   ║   ║ ║
╠ ╬ ╬ ╬ ╬ ╬ ╬ ╬ ╬ ╬ ╬ ╬ ╬ ╬ ╬ ╣
║ ║   ║   ║ ║ ║   ║         ║ ║
╠ ╬ ╬ ╬ ╬ ╬ ╬ ╬ ╬ ╬ ╬ ╬ ╬ ╬ ╬ ╣
║ ║ ║ ║ ║ ║ ║ ║             ║ ║
╠ ╬ ╬ ╬ ╬ ╬ ╬ ╬ ╬ ╬ ╬ ╬ ╬ ╬ ╬ ╣
║ ║ ║ ║ ║ ║ ║ ║   ║ ║       ║ ║
╠ ╬ ╬ ╬ ╬ ╬ ╬ ╬ ╬ ╬ ╬ ╬ ╬ ╬ ╬ ╣
║   ║   ║   ║   ║   ║       ║ ║
╚═╩═╩═╩═╩═╩═╩═╩═╩═╩═╩═╩═╩═╩═╩ ╣
                     \|/      ║
                       ═══════╝